NO ./textures/red.xpm
SO ./textures/bluestone.xpm
WE ./textures/greystone.xpm
EA ./textures/eagle.xpm

F 244,164,96
C 0,191,255
                 1
        1111111110111111111111111
        1000000000000000000000001111111                                                    
       1000000000000000000N00001                                                         
        1000000000000000010100001111111                                                    
        1000000000000000010100001111111                                                    
        1000000000000000010100001111111                                                    
        1000000000000000010100001111111                                                    
        1000000000000000010100001111111                                                    
        1000000000000000010100001111111                                                    
        1000000000000000010100001111111                                                    
        1000000000000000010100001111111                                                    
        1000000000000000010100001111111                                                    
        1000000000000000010100001111111       11111111111111111111111                                             
        1000000000000000010100001111111      1000000000000000010100001111111                                           
        100000000000000001010000111111111111100000000000000000000000000000001                     
        100000000000000001010000000000000000000000000000000000000000000000001                    
        10000000000000000101000011111111111111000000000000000010100001111111                                          
        1000000000000000010100001111111       11111111111111111111111                                             
        1000000000000000010100001111111                                                    
        1000000000000000010100001111111                                                    
        1000000000000000010100001111111                                                    
        1000000000000000010100001111111                                                    
        1000000000000000010100001111111                                                    
        1000000000000000010100001111111                                                    
        1000000000000000010100001111111                                                    
        1000000000000000010100001111111                                                    
        1000000000000000000000001111111                                                    
        1000000000000000000000001
        1111111111111011111111111
                     1
                     1
