NO ./textures/red.xpm
SO ./textures/bluestone.xpm
WE ./textures/greystone.xpm
EA ./textures/eagle.xpm

F 244,164,96
C 0,191,255

        1111111111111111111111111
        1000000000000000000000001
       100000000000000000N0000001
        1000000000000000000000001
        1000000000000000000000001
        1111111111111011111111111
                     1
