






NO ./textures/red.xpm



SO ./textures/bluestone.xpm



WE ./textures/greystone.xpm




EA                  ./textures/eagle.xpm   

F 244,164,96
C 1,1,0


















































                   1
       111111111111S111111111111111
       100000000000000000000011111                                                    
       10000000000000000000000011                                                        
        1000000000000000010100001111111                                                    
        100000000000000010100001111111                                                    
        1000000000000000010100001111111                                                    
        1000000000000000010100001111111                                                    
        1000000000000000010100001111111                                                    
        1000000000000000010100001111111                                                    
        1000000000000000010100001111111                                                    
        1000000000000000010100001111111                                                    
        1000000000000000010100001111111                                                    
        1000000000000000010100001111111       11111111111111111111111       1                                     
        1000000000000000010100001111111      100000000000000001010000111111101                                         
        100000000000000001010000111111111111100000000000000000000000000000001                     
        100000000000000001010000000000000000000000000000000000000000000000001                    
        10000000000000000101000011111111111111000000000000000010100001111111                                          
        1000000000000000010100001111111       11111111110111111111111                                             
        1000000000000000010100001111111                101                                    
        1000000000000000010100001111111                101                                    
        1000000000000000010100001111111                101                                    
        1000000000000000010100001111111               10001                                  
        1000000000000000010100001111111              1000001                                 
        1000000000000000010100001111111             100000001                               
        1000000000000000010100001111111              1000001                                
        1000000000000000010100001111111               10001                                
        1000000000000000000000001111111                101                                 
        1000000000000000000000001                      101
        1111111111111011111111111                      101
                     1                                 101  
                     1                                 111





