NO ./textures/red.xpm
SO ./textures/bluestone.xpm
WE ./textures/greystone.xpm
EA ./textures/eagle.xpm

F 244,164,96
C 0,191,255
                 1
        1111111110111111111111111
        1000000000000000000000001111111                                                    
       10000000000000000N000000001                                                         
        1000000000000000000000001111111                                                    
        1000000000000000000000001
        1111111111111011111111111
                     1
                     1
