NO ./textures/red.xpm
SO ./textures/bluestone.xpm
WE ./textures/greystone.xpm
EA ./textures/eagle.xpm

F 244,164,96
C 0,191,255

        1111111111111111111111111  1
        1000000000110011011000001            1
        1000000000110011001000001  1
        1000000000110011001000001  1
        1000000000110011001000001  1
        1000000000110011N01000001  1
        1111111111111111111111111  1